The flag 'temp' used in rule sourmash_taxonomy is only valid for outputs, not inputs.
Building DAG of jobs...
Using shell: /usr/bin/bash
Provided cores: 36
Rules claiming more threads will be scaled down.
Provided resources: mem_mb=1000, mem_mib=954, disk_mb=1000, disk_mib=954
Select jobs to execute...

[Tue Nov 28 11:11:02 2023]
rule mmseqs_taxonomy:
    input: ../../output/taxonomy_annotation_workflow/subsampled_assemblies/large.fasta
    output: ../../output/taxonomy_annotation_workflow/mmseqs_UniRef90/large.tsv
    jobid: 0
    reason: Missing output files: ../../output/taxonomy_annotation_workflow/mmseqs_UniRef90/large.tsv
    wildcards: database=UniRef90, size_fraction=large
    resources: mem_mb=1000, mem_mib=954, disk_mb=1000, disk_mib=954, tmpdir=/tmp

createdb ../../output/taxonomy_annotation_workflow/subsampled_assemblies/large.fasta ../../output/taxonomy_annotation_workflow/mmseqs_UniRef90/large_query 

MMseqs Version:       	14.7e284
Database type         	0
Shuffle input database	true
Createdb mode         	0
Write lookup file     	1
Offset of numeric ids 	0
Compressed            	0
Verbosity             	3

Converting sequences
[
Time for merging to large_query_h: 0h 0m 0s 170ms
Time for merging to large_query: 0h 0m 0s 170ms
Database type: Aminoacid
Time for processing: 0h 0m 0s 834ms
taxonomy ../../output/taxonomy_annotation_workflow/mmseqs_UniRef90/large_query /vortexfs1/omics/alexander/data/databases/mmseqs2/UniRef90 ../../output/taxonomy_annotation_workflow/mmseqs_UniRef90/large ../../output/taxonomy_annotation_workflow/mmseqs_UniRef90/large_tmp 

MMseqs Version:                        	14.7e284
ORF filter                             	1
ORF filter e-value                     	100
ORF filter sensitivity                 	2
LCA mode                               	3
Taxonomy output mode                   	0
Majority threshold                     	0.5
Vote mode                              	1
LCA ranks                              	
Column with taxonomic lineage          	0
Compressed                             	0
Threads                                	36
Verbosity                              	3
Taxon blacklist                        	12908:unclassified sequences,28384:other sequences
Substitution matrix                    	aa:blosum62.out,nucl:nucleotide.out
Add backtrace                          	false
Alignment mode                         	1
Alignment mode                         	0
Allow wrapped scoring                  	false
E-value threshold                      	1
Seq. id. threshold                     	0
Min alignment length                   	0
Seq. id. mode                          	0
Alternative alignments                 	0
Coverage threshold                     	0
Coverage mode                          	0
Max sequence length                    	65535
Compositional bias                     	1
Compositional bias                     	1
Max reject                             	5
Max accept                             	30
Include identical seq. id.             	false
Preload mode                           	0
Pseudo count a                         	substitution:1.100,context:1.400
Pseudo count b                         	substitution:4.100,context:5.800
Score bias                             	0
Realign hits                           	false
Realign score bias                     	-0.2
Realign max seqs                       	2147483647
Correlation score weight               	0
Gap open cost                          	aa:11,nucl:5
Gap extension cost                     	aa:1,nucl:2
Zdrop                                  	40
Seed substitution matrix               	aa:VTML80.out,nucl:nucleotide.out
Sensitivity                            	2
k-mer length                           	0
k-score                                	seq:2147483647,prof:2147483647
Alphabet size                          	aa:21,nucl:5
Max results per query                  	300
Split database                         	0
Split mode                             	2
Split memory limit                     	0
Diagonal scoring                       	true
Exact k-mer matching                   	0
Mask residues                          	1
Mask residues probability              	0.9
Mask lower case residues               	0
Minimum diagonal score                 	15
Selected taxa                          	
Spaced k-mers                          	1
Spaced k-mer pattern                   	
Local temporary path                   	
Rescore mode                           	0
Remove hits by seq. id. and coverage   	false
Sort results                           	0
Mask profile                           	1
Profile E-value threshold              	0.001
Global sequence weighting              	false
Allow deletions                        	false
Filter MSA                             	1
Use filter only at N seqs              	0
Maximum seq. id. threshold             	0.9
Minimum seq. id.                       	0.0
Minimum score per column               	-20
Minimum coverage                       	0
Select N most diverse seqs             	1000
Pseudo count mode                      	0
Gap pseudo count                       	10
Min codons in orf                      	30
Max codons in length                   	32734
Max orf gaps                           	2147483647
Contig start mode                      	2
Contig end mode                        	2
Orf start mode                         	1
Forward frames                         	1,2,3
Reverse frames                         	1,2,3
Translation table                      	1
Translate orf                          	0
Use all table starts                   	false
Offset of numeric ids                  	0
Create lookup                          	0
Add orf stop                           	false
Overlap between sequences              	0
Sequence split mode                    	1
Header split mode                      	0
Chain overlapping alignments           	0
Merge query                            	1
Search type                            	0
Exhaustive search mode                 	false
Filter results during exhaustive search	0
Strand selection                       	1
LCA search mode                        	false
Disk space limit                       	0
MPI runner                             	
Force restart with latest tmp          	false
Remove temporary files                 	false

Input taxonomy database "/vortexfs1/omics/alexander/data/databases/mmseqs2/UniRef90" is missing files:
- /vortexfs1/omics/alexander/data/databases/mmseqs2/UniRef90_nodes.dmp
- /vortexfs1/omics/alexander/data/databases/mmseqs2/UniRef90_names.dmp
- /vortexfs1/omics/alexander/data/databases/mmseqs2/UniRef90_merged.dmp
[Tue Nov 28 11:11:03 2023]
Error in rule mmseqs_taxonomy:
    jobid: 0
    input: ../../output/taxonomy_annotation_workflow/subsampled_assemblies/large.fasta
    output: ../../output/taxonomy_annotation_workflow/mmseqs_UniRef90/large.tsv
    shell:
        
        mmseqs createdb ../../output/taxonomy_annotation_workflow/subsampled_assemblies/large.fasta ../../output/taxonomy_annotation_workflow/mmseqs_UniRef90/large_query
        mmseqs taxonomy ../../output/taxonomy_annotation_workflow/mmseqs_UniRef90/large_query /vortexfs1/omics/alexander/data/databases/mmseqs2/UniRef90 ../../output/taxonomy_annotation_workflow/mmseqs_UniRef90/large ../../output/taxonomy_annotation_workflow/mmseqs_UniRef90/large_tmp
        mmseqs createtsv ../../output/taxonomy_annotation_workflow/mmseqs_UniRef90/large_query ../../output/taxonomy_annotation_workflow/mmseqs_UniRef90/large ../../output/taxonomy_annotation_workflow/mmseqs_UniRef90/large.tsv
        
        (one of the commands exited with non-zero exit code; note that snakemake uses bash strict mode!)

Shutting down, this might take some time.
Exiting because a job execution failed. Look above for error message
